tambien
carpintero
principiantes - inexperienced
my (singular) - mi
my (plural) - mis
your (singular) - tu
your (plural) - tus
su 
sus
nuestro/nuestra
nuestros/nuestras
este/esta (near the speaker)
estos estas (near the speaker)
ese/esa (near the listener)
esos/esas (near the listener)
aquel/aquella (far from both)
aquellos/aquellas (far from both)
revista 
esto - neuter pronoun
eso - neuter pronoun
aquello - neuter pronoun (farther away in place or time)
Sitio - place
Computadora - computer
Alguno - some/few
Ambos - both
Bastante - quite/fairly good
Suficiente - enough
Ultimo- last
Unico - only
Varios - several
Proximo - next
Otro - other
Antiguo - ancient/former
Cierto - certain/sure
Grande - big/ great
Pobre - poor/ unfortunate
Mismo - same/self 
Viejo - old/longtime
Asistir - to attend
el mejor/la mejor - the best
tanto como - as much as 
casi - almost
demasiado - too much
temprano - early 
todavia - still, yet, no, not yet
ya no - no longer
Conducir - to drive
Tomar - to take/to drink
Antes - before
Despues - after
En vez - instead of
Adenas de - in addition to
A pesar - in spite of
Contra - against
Durante - during
Excepto - except 
Havia - toward
Salvo - except 
Segun - according to
Sobre - above on top of
Hasta - until
Desde - since 
Conmigo - with me
Contigo - with you 
Consigo - with himself/herself/themself 
Encima - on
Aparecer - to appear
Votar - to vote
Comodo - comfortable
La prueba - the test
Haragan - lazy
Costumbre - habit
Contestar - to answer
Intentar - to try
La verdad - the truth
Tener exito - to have success
Pagar - to pay
Tata - so much
Llegar - to arrive
Frecuentemente - frequently 
estrecho - narrow
Terremoto - earthquake 
Abrir - to open
Acabar de - finish
Aceptar - to accept
Ahorrar - to save
Almorzar - to have lunch
Aparecer - to appear (irregular)
Arreglar - to fix/to repair
Bajar - to go down 
Cambiar - to change
Celebrar - to celebrate
Compartir - to share
Comprender - to understand
Contestar - to answer
Cruzar - to cross
Deber - to owe/should
Dejar de - to stop
Descansar - to rest
Dibujar - to draw
Disfrutar - to enjoy
Doblar - to fold/to turn
Encontrar - to find
Explicar - to explain
Firmar - to sign
Fumar - to smoke
Gozar - to enjoy
Limpiar - to clean
Llegar - to arrive
Llenar - to fill
Llevar - to take/to wear
Llorar - to cry
Manejar - to handle/to drive
Marcar - to mark
Meter - to put
Mirar - to look at
Parar - to stop
Pasar - to pass/to happen
Pintar - to paint
Prender - to light/to turn on
Preparar - to prepare
Recibir - to receive
Regresar - to return
Repasar - to review
Repetir - to repeat (Irregular)
Romper - to break
Seguir - to follow
Servir - to serve (irr)
Subir - to rise/ to go up
Tirar - to throw away
Tomar - to take
Tratar de - to try